Year,Quarter,1. Net profit/(loss) before tax,2. Accumulated depreciation,3. Provisions,4. Unrealised foreign exchange gain/loss,5. (Profit)/loss from liquidation of fixed assets,6. Profits/losses from investments,7. Interest expense,8. Interest income and dividend,9. Operating profit/(loss) before changes in WC,10. (Increase)/decrease in receivables,11. (Increase)/decrease in inventories,12. Increase/(decrease) in payables,13. (Increase)/decrease in prepaid expenses,14. Interest paid,15. Business Income Tax Paid,16. Other receipts from operating activities,17. Cash for other business activities,Net cash inflows(outflows) from operating activities,1. Purchases of fixed assets and other long term assets,2. Proceeds from disposal of fixed assets,"3. Loans granted, purchases of debt instruments","4. Collection of loans, proceeds from sales of debts instruments",5. Investments in other entities,6. Proceeds from divestment in other entities,7. Dividends and interest received,Net cash inflows/(outflows) from investing activities,1. Proceeds from issue of shares,2. Payments for share returns and repurchases,3. Proceeds from borrowings,4. Repayment of borrowings,5. Finance lease principal payments,6. Dividends paid,7. Interest received,Net cash inflows/(outflows) from financing activities,Net increase in cash and cash equivalents,Cash and cash equivalents at the beginning period,Effect of foreign exchange differences,Cash and cash equivalents at the end of period
2009,1,1925302817,2560235873,0,-1271074,0,0,1490586120,0,5974853736,-16219242870,-1745098687,33093720819,-299048601,-1490586120,-90971959,18458603,-151311908,19090773013,-23583338459,0,0,0,0,0,141683889,-23441654570,23384292,0,13210585765,-10377100765,0,-1195668000,0,1661201292,-2689680265,20061870307,0,17372190042
2010,1,2749813114,3452804181,0,12261425,0,-163772700,1294361114,0,7345467134,-4118042891,-1114036755,3362751047,-1085090896,-1294361114,-873418356,121509260,-1546337538,798439891,-6526415153,0,0,0,0,0,506231865,-6020183288,0,0,11923574161,-9944281367,0,-261565000,0,1717727794,-3504015603,26038744251,0,22534728648
2010,2,9922358015,6985129850,0,0,0,-899514981,2887917931,0,18895890815,-2030934562,-769749969,-2939249013,230759021,-2887917931,-1539547274,0,-384380500,8574870587,-10821351184,0,0,9000000000,0,0,1119513301,-701837883,157027500,19812424058,-18679409630,-6715817000,0,0,0,-5425775072,2447257632,26038744251,193610281,28679612164
2010,3,14137778603,10745427945,0,40661794,0,-1086208181,4475324478,0,28312984639,-8681629159,-1754238103,2538945466,711276793,-4475324478,-2847233330,22233154,-692957278,13134057704,-13357353188,0,0,0,0,0,1572059854,-11785293334,157027500,0,29732734163,-29370422658,0,-7204488325,0,-6685149320,-5336384950,26038744251,-5853302,20696505999
2011,1,4019776095,3844317700,0,0,0,-788235849,1821997661,0,8897855607,-1398605664,2705381571,3669762592,-32899186,-1821997661,-860343045,19698865,-1031345037,10147508042,-140474545,0,-1500000000,2000000000,0,0,823192873,1182718328,0,-1823081886,8271000599,-10825491620,0,-756000000,0,-5133572907,6196653463,34403318961,0,40599972424
2011,2,8195061006,3786760574,0,-47950944,0,-1406768558,1739661646,0,12266763724,4699494527,-4437435337,-7740626485,-183660821,-1739661646,-1102537839,7368035,186726394,1956430552,-1602461736,80000000,1500000000,-2000000000,0,0,1327826216,-694635520,0,0,8748074569,-12021145236,0,-4138500000,0,-7411570667,-6149775635,40599972424,47950944,34498147733
2011,3,6955303623,3922831424,0,-272141030,0,23168917,1759207478,0,12388370412,-589718285,-2955906474,841674508,422883728,-1759207478,-1784377115,70000000,-27010617,6606708679,-523476360,-80000000,0,0,0,0,1483490330,880013970,0,0,7003078711,-9135761000,0,-1606280000,0,-3738962289,3747760360,34498147733,-47950944,38197957149
2011,4,567622263,3760103078,3064474317,320091974,0,-1146500241,1665737615,0,8231529006,-789768934,-3505373945,2027781184,828943510,-1665737615,-1624280057,69246944,-80796694,3491543399,-1838587249,180500000,0,0,0,0,1298703315,-359383934,0,0,9142325087,-6768175608,0,-1054770000,0,1319379479,4451538944,38197957149,0,42649496093
2012,1,3864930250,3748846164,0,0,0,-437610031,1403286678,0,8579453061,3360441236,3151445455,-3910076104,-1019166086,-1403286678,-451673215,268574293,-1268121963,7307589999,-1305411278,0,-4400000000,0,-5000000000,1050000000,510074000,-9145337278,0,0,11884789217,-25434256261,0,-9260695210,0,-22810162254,-24647909533,42801538784,0,18153629251
2012,2,1459401229,3753688212,3866574755,0,0,-851295648,91832661,0,8320201209,6042444055,-1452041679,-3335441848,-241119244,-91832661,-760541124,-268574293,53530858,8266625273,-906633478,0,4000000000,5517772912,5000000000,0,731559215,14342698649,0,0,12464129174,-32997607888,0,581165210,0,-19952313504,2657010418,18153629251,0,20810639669
2012,3,7914489804,3756654152,-64735052,0,0,-525930420,0,0,11080478484,1363282283,-2098279210,-4383906871,315132100,0,-1039685403,719140586,391553017,6347714986,-779596660,0,-5592000000,0,0,0,2184534458,-4187062202,0,0,4865441750,0,0,-2297647977,0,2567793773,4728446557,20810639669,0,25539086226
2012,4,4868586946,3773950085,959937906,0,0,2171083558,205593696,0,11979152191,-1805152601,-607984892,2282552452,148063361,-205593696,-1680562056,-510583224,-927634673,8672256862,-1769683437,0,5592000000,0,0,0,147109865,3969426428,0,0,0,-4865441750,0,-7857822023,0,-12723263773,-81580483,25539086226,0,25457505743
2013,1,6400296255,4129003657,0,0,0,51849849,3449747,0,10584599508,-4853143735,-3168924698,-281910210,763214195,-3449747,-1188037204,1791602480,0,3643950589,-8733322283,370000000,0,0,0,0,433721878,-7929600405,0,0,1881680386,-1881680386,0,-261565000,0,-261565000,-4547214816,25457505743,0,20910290927
2013,2,17877779217,7617503878,-271540789,0,0,652553462,3449747,0,25879745515,-1989001819,-395987314,-5359524367,209275873,-3449747,-2629802441,0,-117954991,15593300709,-13987232252,993000000,0,0,0,0,641536763,-12352695489,0,0,1881680396,-1881680396,0,0,0,0,3240605220,25457505743,0,28698110963
2013,3,-479900392,-63022561,0,0,0,-1175551122,-3449747,0,-1721923822,7747939465,2851038469,5773519298,-1076953346,3449747,-1845455394,-1791602480,-328399983,9611611954,-1564722587,-370000000,-2292000000,0,0,0,18119071,-4208603516,0,0,-1881680396,1881680396,0,-784695000,0,-784695000,4618313438,24150896147,0,28769209585
2013,4,1668959129,4199209491,810374621,0,0,471147811,0,0,7149691052,-2893618916,-1093300761,-5890818957,176387023,0,1620293025,268447939,-505020661,-1167940256,-2686142711,100000000,-3000000000,0,0,0,185688741,-5400453970,0,0,0,0,0,-4176087900,0,-4176087900,-10744482126,28769209585,0,18024727459
2014,1,1564571768,4500176410,0,0,0,0,0,0,6064748178,83890048,-361706926,-2849687035,-222916772,0,-755035207,0,-364208624,1595083662,-1259170036,0,-2381000000,5292000000,0,0,337924402,1989754366,0,0,0,0,0,-8404689800,0,-8404689800,-4819851772,18024727459,0,13204875687
2014,2,2157096763,4463895276,-406349540,0,0,-469583042,0,0,5745059457,-1091479217,4880785652,-2626147255,3151572372,0,-238035870,0,239890631,10061645770,446226727,0,-3130000000,0,0,0,316537333,-2367235940,0,0,0,0,0,-692037300,0,-692037300,7002372530,13204875687,0,20207248217
2014,3,4095756810,3105128752,0,0,0,-280125851,0,0,6920759711,-4565322530,886543073,2792415564,950357562,0,-87123310,0,-128097053,6769533017,-2640337444,0,-2547000000,2381000000,0,0,95247158,-2711090286,0,0,0,0,0,-251870000,0,-251870000,3806572731,20207248217,0,24013820948
2014,4,7354621991,5800713055,-418967946,0,0,-399833789,0,0,12336533311,-4400647818,-3032211948,5747727251,-1036777270,0,-1148630655,0,-92282106,8373710765,-9436416294,0,-2000000000,3130000000,0,0,399833789,-7906582505,0,0,0,0,0,-503740000,0,-503740000,-36611740,24013820948,0,23977209208
2015,1,4871728766,4522160704,0,0,0,-318350571,0,0,9075538899,984588296,-2845297021,-448679399,799047156,0,-1687165471,0,-569190865,5308841595,-3268200000,0,-3500000000,2547000000,0,0,318350571,-3902849429,0,0,0,0,0,-8004582250,0,-8004582250,-6598590084,23977209208,0,17378619124
2015,2,14341619193,4505898527,0,0,0,-378060281,18888889,0,18488346328,-21579037792,7527876041,7200392630,-1903728577,-18888889,-1044173039,0,446400865,9117187567,-13239981818,110909091,-8520000000,2000000000,0,0,185333008,-19463739719,0,0,4000000000,-8255952250,0,8004582250,0,3748630000,-6597922152,17378619124,0,10780696972
2015,3,14353617409,4777831827,0,0,0,-262807967,12277444,0,18880918713,4783817166,1886247747,918173359,1053040478,-12277445,-4184760325,0,0,23325159693,-13524000000,0,-5209000000,3500000000,0,0,162807967,-15070192033,0,0,0,4255952250,0,-8255952250,0,-4000000000,4254967660,8780696973,0,13035664633
2016,1,9887564037,5281591979,0,0,0,-229834604,0,0,14939321412,-757631666,-5868889928,4045575244,-2860058268,0,-2311330737,0,-2300000,7184686057,-9101900000,0,0,4200000000,0,0,541481595,-4360418405,0,0,4000000000,-5000000000,0,0,0,-1000000000,1824267652,9108966865,0,10933234517
2016,2,25232022677,5396088844,1614750932,0,0,-647382744,140625000,0,31736104709,-6705086485,4664156444,-3282966703,659452767,-140625000,-1635926870,0,0,25295108862,-14562280001,145454545,-14512785556,6000000000,0,0,108463026,-22821147986,0,0,5000000000,-4000000000,0,-1051584000,0,-51584000,2422376876,10933234517,0,13355611393
2016,3,17733938434,5605269819,0,0,0,-54462444,38231951,0,23322977760,-875189184,-108366121,4311329486,443499139,-38231951,-4911992889,0,-1880000,22142146240,-3761997316,0,-2000000000,300000000,0,0,54462444,-5407534872,0,0,10000000000,-20749790172,0,1051584000,0,-9698206172,7036405196,13355611393,0,20392016589
2016,4,11070351745,5953455117,3551414551,0,0,-385537031,0,0,20189684382,-29324837976,-2014106059,22913041286,529296107,0,-3895222340,0,4180000,8402035400,-5761140852,14545455,2000000000,7545000000,0,0,-1771623888,2026780715,0,0,0,5749790172,0,-13999340000,0,-8249549828,2179266287,20392016589,0,22571282876
2017,1,12904042101,5694571911,0,0,0,-174926525,0,0,18423687487,-43383472199,1165865404,41941355570,-1879511865,0,-2609824292,0,-2400000,13655700105,-435401818,0,0,-8025000000,0,0,130022658,-8330379160,0,0,0,0,0,-503740000,0,-503740000,4821580945,22574962256,0,27396543201
2017,2,22724856007,6254800534,-1333865494,17295509,0,-372193890,0,0,27290892666,-5527826774,-5189083275,9189772924,229323737,0,-1678716557,0,-6410000,24307952721,-23935266866,49090908,-13025000000,15397000000,-7735200000,0,419981314,-28829394644,0,0,0,0,0,-4078750000,0,-4078750000,-8600191923,27396543201,3461805,18799813083
2017,3,14520576747,6975438433,0,0,0,-460799597,90668572,0,21125884155,-15357209533,-333303667,-2309669633,515337803,-90668572,-3622204987,0,-1500000,-73334434,-13021891581,0,-3545047263,3110842055,0,0,408825132,-13047271657,13778000000,0,13029906499,0,0,0,0,26807906499,13687300408,18799813083,0,32487113491
2017,4,10529531466,7401172374,4018598438,-17295509,0,-178590024,69277990,0,21822694735,17127300894,-3125685234,8820028434,-16865369058,-69277990,-2589573823,0,-1000000,25119117958,-20459631090,112363636,0,4460000000,0,0,201505509,-15685761945,2162832,0,0,-13029906499,0,-8878130000,0,-21905873667,-12472517654,32487113491,0,20014595837
2018,1,10787057699,7755395652,0,0,0,-381817311,11835616,0,18172471656,45029174493,-3662989160,-46017772310,1153161448,-11835616,-4052447839,0,0,10609762672,-21722915000,54545454,0,9033990764,0,0,331251857,-12303126925,0,0,8000000000,-8000000000,0,-364350000,0,-364350000,-2057714253,20019926107,20215749,17982427603
2018,2,23771392672,8386146147,2508620800,-35449287,0,-24466555,49361068,0,34655604845,5443718196,907405399,-3195913035,1233427459,-49361068,-1686494008,0,0,37308387788,-23142840651,0,0,0,0,0,20486555,-23122354096,0,0,19282483810,-19245831301,0,-12750000000,0,-12713347491,1472686201,17982427603,-9045520,19446068284
2018,3,16113620405,8827571531,-606213200,0,0,-36705749,214645,0,24298487632,5043404285,1915934664,-5746800795,-3386052928,-214645,-5372749525,0,-1800000,16750208688,-7028185202,35454546,0,0,0,0,9433022,-6983297634,0,0,0,-36652509,0,0,0,-36652509,9730258545,19446068284,0,29176326829
2018,4,18502230140,9438822276,621634145,0,0,-236494140,0,0,28326192421,-5514754941,1568753007,11696675767,1271753693,0,-3509785639,0,-500000,33838334308,-13396829536,70000000,-6063771930,6000000000,0,0,318312321,-13072289145,0,0,0,0,0,-12750000000,0,-12750000000,8016045163,29176326829,0,37192371992
2019,1,17338981489,9512959179,0,-35449287,0,-206846740,0,0,26609644641,3822313853,-10713578890,-11164001824,-1427047948,0,-4299535937,0,-2670000000,157793895,-23471209301,60000000,0,0,0,0,172301293,-23238908008,0,0,6626435346,0,0,-607250000,0,6019185346,-17061928767,37212291914,0,20150363147
2019,2,23986262624,10103453160,2161920645,19522734,0,-57084991,63781021,0,36277855193,-10663682009,1850311830,-3705757382,-93948944,-63781021,-4360607717,0,-2346000,19238043950,-28003744630,-60000000,0,0,0,0,84357718,-27979386912,44784192200,0,14995455256,-21571890602,0,-8500000000,0,29707756854,20966413892,20150363147,25205825,41141982864
2019,3,17167231623,10732942281,0,-56705120,0,-1954904853,195890,0,25888759821,13668412288,-4872729598,-6380994962,-2186086623,-195890,-3703272333,0,2346000,22416238703,-26883934700,2200000000,0,0,0,0,334975931,-24348958769,0,0,-50000000,0,0,0,0,-50000000,-1982720066,41141982864,-25205825,39134056973
2019,4,18900584451,11836581487,961100,-2108134,0,-156868795,0,0,30579150109,6530615960,-2731949608,4338025864,1102277600,0,-3827745630,0,-7346000,35983028295,-21727119898,1305000000,0,0,0,0,343150013,-20078969885,0,0,50000000,0,0,-15000000000,0,-14950000000,954058410,39134056973,0,40088115383
2020,1,18152064791,12066428451,0,-27266602,0,-186430154,0,0,30004796486,-12796474309,-2928733705,4912333391,2710469710,0,-4039094903,0,0,17863296670,-10387120000,0,0,0,0,0,186430154,-10200689846,0,0,0,0,0,0,0,0,7662606824,40113853116,0,47776459940
2020,2,29105087949,12193134095,279896791,-39709852,0,551153093,0,0,42089562076,9917789512,-2247189177,-11784979973,-1286980586,0,4039094903,-6713580074,0,34013716681,-7577625000,350000000,0,0,0,0,79586745,-7148038255,0,0,0,0,0,-10607250000,0,-10607250000,16258428426,47776459940,0,64034888366
2020,3,18886682740,12662007755,0,-21561914,0,366825175,0,0,31893953756,10114821421,-907087350,-20658724584,1318855159,0,-3821373720,0,705229999,18645674681,-4007494500,277272728,0,-668285881,-4155900000,0,437016010,-8117391643,0,0,0,0,0,70000,0,70000,10528353038,64034888366,0,74563241404
